6 6 6 6 6 6 6 6 6 6 6 6 6 6 6
6 0 0 0 0 0 0 0 0 0 0 0 0 0 6
6 0 0 0 0 0 0 0 0 0 0 0 0 0 6
6 0 0 0 0 0 0 0 0 0 0 0 0 0 6
6 0 0 0 0 4 6 0 0 2 0 0 0 3 6
6 0 0 0 0 0 0 0 0 1 2 6 0 3 6
6 0 0 0 0 0 0 0 0 0 0 0 0 0 6
6 0 0 4 0 0 0 0 0 0 0 0 0 0 6
6 0 0 0 0 0 0 0 0 0 0 0 0 0 6
6 6 6 6 6 6 6 6 6 6 6 6 6 6 6