6 6 6 6 6 6 6 6 6 6 6 6 6 6 6
6 6 6 6 6 6 6 6 6 6 6 6 6 6 6
6 6 6 6 6 0 0 6 0 0 6 6 6 6 6
6 6 6 6 0 2 0 6 0 2 0 0 6 6 6
6 6 6 6 0 0 3 1 3 0 0 0 6 6 6
6 6 6 6 6 2 0 6 0 2 6 6 6 6 6
6 6 6 6 6 0 3 0 3 0 6 6 6 6 6
6 6 6 6 6 6 6 6 6 6 6 6 6 6 6
6 6 6 6 6 6 6 6 6 6 6 6 6 6 6
6 6 6 6 6 6 6 6 6 6 6 6 6 6 6