6 6 6 6 6 6 6 6 6 6 6 6 6 6 6
6 0 0 0 0 0 0 0 0 0 0 0 0 0 6
6 0 0 0 0 0 0 0 0 0 0 0 0 0 6
6 0 0 0 0 0 0 0 0 0 0 0 0 0 6
6 0 0 0 0 0 2 0 6 6 2 6 6 6 6
6 0 0 0 0 2 0 6 3 0 3 0 0 0 6
6 0 0 0 2 0 6 3 0 0 0 0 0 0 6
6 0 0 2 0 6 3 0 0 0 0 0 0 0 6
6 0 0 1 6 3 0 0 0 0 0 0 0 0 6
6 6 6 6 6 6 6 6 6 6 6 6 6 6 6